00000000000000
00020302003000
02000000000000
02000000000000
03000000000000
00000000000000
00000000000000
02000000000000
02000000000000
00000000000000
03000000000000
00000000000000
00000223220000
00000000000000
