00000000000010
02154321543200
03000000000001
04015432154320
05020000000000
01030543215432
02040100000001
03050203215405
04010304000304
05020000000203
01034512345102
02000000000001
03451234512345
00000000000000
