010030102010
000030102010
000030102010
000030102010
000030102010
002030102010
002030102010
102010102010
102010102010
102010102010
100010102010
100010102010