000020102010
002010102010
002020202010
002010202010
002020202010
002010202010
002020102010
102210102010
102010102010
102010102010
100010102010
100010102010