00000000000000
01231231231230
02000000000010
03031231231020
01010000002030
02020123103010
03030200201020
01010300302030
02020123103010
03030000001020
01031231231030
02000000000010
01231231231230
00000000000000
