00201000010200
00301000010300
23200000000232
00000000000000
11003000300011
00000202000000
00000232000000
00000313000000
00000232000000
11000202000011
00003000300000
23200000000232
00301000010300
00201000010200