000000000000
000123311000
002000000200
002012110100
001010010200
002020010100
003010020200
002013130100
003000000200
000312133000
000000000000
000000000000