000000000000
000121221000
002000000200
002012110100
001010010200
002020010100
001010020200
002012110100
001000000200
000212121000
000000000000
000000000000